11111111111111111111111111111111111111111111111111111111111111111111111111111111111111111111
10000000000000000000000000000000000000000000000000000000000000000000000000000000000000000001
10000000000000000000000000000000000000000000000000000000000000000000000000000000000000000001
10000000000000000000000000000000000000000000000000000000000000000000000000000000000000000001
10000000000000000000000000000000000000000000000000000000000000000000000000000000000000004001
10000000000000000000000000000000000000000111111111111111111111111111111111111111111111111111
10000000000000111111111111111111111111111100000000000000000000000000000000000000000000000001
10000000111100000000000000000000000000000000000000000000000000000000000000000000000000000001
10000000000000000000000000000000000000000000000000000000000000000000000000000000000000000001
10000000000000000000000000000000000000000000000000000000000000000000000000000000000000000001
11111111111111111111111111111111111111111000000000000000000000000000000000000000000000000001
10000000000000000000000000000000000000000000111111111111111111111110000000000000000000000001
10000000000000000000000000000000000000000000000000000000000000000011111111111111111000000001
10000000000000000000000000000000000000000000000000000000000000000000000000000000000000000001
10000000000000000000000000000000000000000000000000000000000000000000000000000000000000000001
10000000000000000000000000000000000000000000000000001111111111111111111111111111111111111111
10000000000000001111111111111111100001111111111111111000000000000000000000000000000000000000
11111111111111111000000000000000000000000000000000000000000000000000000000000000000000000000